1111111111
1000010E01
1P0X010001
1000010001
1000C00001
1111111111