1111111111
1P00010E01
1C00010001
10C0010C01
1000000001
1111111111