111111111111111111111111
1P0000000000010000000001
100001111100001111100001
100000000000000000000001
100111000111110001110001
100100000000000000010001
100100011111111100010001
100100010000001100010001
100100010111101100010001
100100010100001100010001
100100000100001000010001
1001000001C0001000010001
100100000111110001000001
100100000000000001000001
100111110000001111100001
100000000000000000000001
100001111100001111100001
100000000000X0000000E001
1000000000C0000000000001
111111111111111111111111
