111111111111111111111111111111111111111111111111111111111111111111111111111111
1P0000000000000000000000000000000000000000000000000000000000000000E00000000001
100000000000000011111111111000000000000000000011111111111111111100000000000001
100000000000000010000000001000000000000000000010000000000000001100000000000001
100000000000000010000000001000000000000000000010000000000000001100000000000001
100000000000000011111111101111110000000000000011111111000000001111111110000001
100000000000000000000000000000010000000000000000000001000000000000000000000001
100000000000000000000000000000010000000000000000000001000000000000000000000001
111111111111111111111111111110011111111111111111111101111111111111111110000001
10000000000000000000000000C000000000000000000000000000000000000000000000000001
100000000000000000000000000000000000000000000000000000000000000000000000000001
100000011111111111111111111111111111111111111111111111111111111111111110000001
100000010000000000000000000000000000000000000000000000000000000000000000000001
100000010000000000000000000000000000000000000000000000000000000000000000000001
100000011111111111111111111111111111111111111111111111111111111111111110000001
100000000000000000000000000000000000000000000000000000000000000000000000000001
100000000000000000000000000000000000000000000000000000000000000000000000000001
100000000000000011111111111111111111111111111111111111111111111111000000000001
1000000000000000100000000000000000000000000C0000000000000000000001000000000001
100000000000000010000000000000000000000000000000000000000000000001000000000001
100000000000000011111111111111111111111111111111111111111111111101000000000001
1000C0000000000000000000000000000000000000000000000000000000000000000000000001
100000000000000000000000000000000000000000000000000000000000000000000000000X01
10000000000000000000000000000000000000000000000C000000000000000000000000000001
100000000000000000000000000000000000000000000000000000000000000000000000000001
100000000000000000000C00000000000000000000000000000000000000000000000000000001
100000000000000000000000000000000000000000000000000000000000000000000000000001
100000000000000000000000000000000000000000000000000000000000000000000000000011
100000000000000000000000000000000000000000000000000000000000000000000100000011
100000000000000000000000000000000000000000000000000000000000000000000000000001
111111111111111111111111111111111111111111111111111111111111111111111111111111
